wwwwwwwwwwwwwwwwwwww
w             w    w
w     P     c w    w
w  w               w
w             ww   w
w        w         w
wwwwwwwwwwwwwwwwwwww
