wwwwwwwwwwwwwwwwwwww
w             w    w
w     P     c w    w
w  G               w
w             ww   w
w        w         w
wwwwwwwwwwwwwwwwwwww
