wwwwwwwwwwwwwwwwwwww
w  G               w
w     P            w
w                  w
w                  w
w        w         w
wwwwwwwwwwwwwwwwwwww
